GGAAAGCCGCTGTGCTAAAG -> GAAAGCCGCTGTGCTAAAGT
CTAAAGAACGCTATTTTAGA -> TAAAGAACGCTATTTTAGAC
CCGAGCTAAATGGAGCTGTA -> CGAGCTAAATGGAGCTGTAC
TTACTGTCACGGCCTAAATC -> TACTGTCACGGCCTAAATCA
CTTACGGATGGCTTACCATA -> TTACGGATGGCTTACCATAG
CACGACTCAATTTACACTCC -> ACGACTCAATTTACACTCCC
ACGTTTTGTCTGAGGCCTCC -> CGTTTTGTCTGAGGCCTCCT
AGTGCTGAGTAGTTTCATTG -> GTGCTGAGTAGTTTCATTGT
TCGAACGAATCTGGAGCGTG -> CGAACGAATCTGGAGCGTGA
TCAAATCTACAATACGCATG -> CAAATCTACAATACGCATGT
CGGGATCTCACCTATAGTTA -> GGGATCTCACCTATAGTTAC
CGATCTCGAGCGAGTCTTCT -> GATCTCGAGCGAGTCTTCTT
CGCTCGATTGTGTGCGCCCG -> GCTCGATTGTGTGCGCCCGT
AAGCCGCTGTGCTAAAGTGC -> AGCCGCTGTGCTAAAGTGCT
AATTTACACTCCCCGTGGCA -> ATTTACACTCCCCGTGGCAA
GCGTCGCTAAACGCGTTTAC -> CGTCGCTAAACGCGTTTACG
ATTTACACTCCCCGTGGCAA -> TTTACACTCCCCGTGGCAAC
CGGGTGCAGTCAAGGCTTGA -> GGGTGCAGTCAAGGCTTGAT
TATCGCGCTTCAGCATTCGT -> ATCGCGCTTCAGCATTCGTT
AACGGTATCGCGCTTCAGCA -> ACGGTATCGCGCTTCAGCAT
GAGCTAAATGGAGCTGTACC -> AGCTAAATGGAGCTGTACCT
ATTGTGTGCGCCCGTTAATT -> TTGTGTGCGCCCGTTAATTT
GATGCGGAGCATATAAGCCC -> ATGCGGAGCATATAAGCCCC
TGTAGGTGGAGCGCTAAAGA -> GTAGGTGGAGCGCTAAAGAA
TCTCACCTATAGTTACACTT -> CTCACCTATAGTTACACTTT
CTATTGGGGACAGATAATTG -> TATTGGGGACAGATAATTGC
CAGAGCAAAGGAGGAAAGCC -> AGAGCAAAGGAGGAAAGCCG
TGTGTATCATTTTCTGTCGA -> GTGTATCATTTTCTGTCGAT
CATTTGAGTCTTTCGAACCG -> ATTTGAGTCTTTCGAACCGT
CATACTGGCCTCCCAGAGCA -> ATACTGGCCTCCCAGAGCAA
GATGGGCACCGCTGTTTAGG -> ATGGGCACCGCTGTTTAGGT
TCCCTATTTACTGTCACGGC -> CCCTATTTACTGTCACGGCC
TTAGAATCCTGCATCCCTAT -> TAGAATCCTGCATCCCTATT
GTCACGACTCAATTTACACT -> TCACGACTCAATTTACACTC
ACGGATTACTGTGGTTTCAC -> CGGATTACTGTGGTTTCACC
AGCCGCTGTGCTAAAGTGCT -> GCCGCTGTGCTAAAGTGCTG
CTCCCAGAGCAAAGGAGGAA -> TCCCAGAGCAAAGGAGGAAA
ATCTGGAGCGTGATGCGGAG -> TCTGGAGCGTGATGCGGAGC
CCTACTCTCCTAGTCACGAC -> CTACTCTCCTAGTCACGACT
GGCCTAAATCACCCAATAGA -> GCCTAAATCACCCAATAGAG
ACAACCTATCATTAATCTTT -> CAACCTATCATTAATCTTTG
GTTAATTTTCGGTTTTGACG -> TTAATTTTCGGTTTTGACGT
TTGCGCATACCCTTTGTGTA -> TGCGCATACCCTTTGTGTAT
ACCATAGCCTAGGCTAGGAC -> CCATAGCCTAGGCTAGGACA
GGACAGATAATTGCGCATAC -> GACAGATAATTGCGCATACC
TATTGGGGACAGATAATTGC -> ATTGGGGACAGATAATTGCG
CGAGGCTGGTCTCGCTCTAC -> GAGGCTGGTCTCGCTCTACC
CGTTGTACCGAGCAACCGCT -> GTTGTACCGAGCAACCGCTT
ATAATTGCGCATACCCTTTG -> TAATTGCGCATACCCTTTGT
TAGAATCACTAGTGTGTTCG -> AGAATCACTAGTGTGTTCGT
TCGAGCGAGTCTTCTTACCT -> CGAGCGAGTCTTCTTACCTC
GAATACGCGACCGACAGCGG -> AATACGCGACCGACAGCGGC
ATGCCGAGCTAAATGGAGCT -> TGCCGAGCTAAATGGAGCTG
CGGATGGCTTACCATAGCCT -> GGATGGCTTACCATAGCCTA
GTTTAGGTAGGTAGCGTAAC -> TTTAGGTAGGTAGCGTAACG
GAGCAAAGGAGGAAAGCCGC -> AGCAAAGGAGGAAAGCCGCT
ACCTGAATCTATTGGGGACA -> CCTGAATCTATTGGGGACAG
GAAACGAGGTCAAGGTCATA -> AAACGAGGTCAAGGTCATAG
GCTAAATGGAGCTGTACCTA -> CTAAATGGAGCTGTACCTAG
CAGTCAAGGCTTGATCCGGT -> AGTCAAGGCTTGATCCGGTG
CACCGCTGTTTAGGTAGGTA -> ACCGCTGTTTAGGTAGGTAG
CGAGCTAAATGGAGCTGTAC -> GAGCTAAATGGAGCTGTACC
ATGGGCACCGCTGTTTAGGT -> TGGGCACCGCTGTTTAGGTA
TGGAAACATTAACAGCCCTT -> GGAAACATTAACAGCCCTTA
AGGTCAAGGTCATAGTGTAG -> GGTCAAGGTCATAGTGTAGG
GGTCAGCCTAATATCAAATC -> GTCAGCCTAATATCAAATCT
TCTGTCGATTATGTCGGGTC -> CTGTCGATTATGTCGGGTCC
TATTTTAGACAGCGTCGCTA -> ATTTTAGACAGCGTCGCTAA
ACCATCTGAGATTTGGGCCT -> CCATCTGAGATTTGGGCCTC
CCTCGAACGAATCTGGAGCG -> CTCGAACGAATCTGGAGCGT
GGGACAGATAATTGCGCATA -> GGACAGATAATTGCGCATAC
TGAAGGACGGGCAACGCTCG -> GAAGGACGGGCAACGCTCGA
CCGAATACCCCGACCTGAAT -> CGAATACCCCGACCTGAATC
ACAGCGGCTTAGACCGCTGA -> CAGCGGCTTAGACCGCTGAG
GTGGCAACCCAGTTCGCCGA -> TGGCAACCCAGTTCGCCGAG
CTGAGTAGTTTCATTGTTGT -> TGAGTAGTTTCATTGTTGTA
GCATATAAGCCCCCAGCATT -> CATATAAGCCCCCAGCATTC
GCAACCGCTTACGGATGGCT -> CAACCGCTTACGGATGGCTT
TACGCGACCGACAGCGGCTT -> ACGCGACCGACAGCGGCTTA
GCTCATACTGGCCTCCCAGA -> CTCATACTGGCCTCCCAGAG
GGCCGATCTCGAGCGAGTCT -> GCCGATCTCGAGCGAGTCTT
ATTACTGTGGTTTCACCATA -> TTACTGTGGTTTCACCATAG
CTCTCCTAGTCACGACTCAA -> TCTCCTAGTCACGACTCAAT
TGCAGATATTATGAACAACC -> GCAGATATTATGAACAACCT
AACCCAGTTCGCCGAGGCTG -> ACCCAGTTCGCCGAGGCTGG
TGTATCATTTTCTGTCGATT -> GTATCATTTTCTGTCGATTA
CTTTTGTGGCAACAGGAAAC -> TTTTGTGGCAACAGGAAACG
CCGAGCAACCGCTTACGGAT -> CGAGCAACCGCTTACGGATG
AGGTAGCGTAACGTTTTGTC -> GGTAGCGTAACGTTTTGTCT
GCGTGATGCGGAGCATATAA -> CGTGATGCGGAGCATATAAG
CGAGTCTTCTTACCTCTTAT -> GAGTCTTCTTACCTCTTATT
CTAGAATCACTAGTGTGTTC -> TAGAATCACTAGTGTGTTCG
TTAGACAGCGTCGCTAAACG -> TAGACAGCGTCGCTAAACGC
ACCTAGATTAGAATCCTGCA -> CCTAGATTAGAATCCTGCAT
TCTGAGGCCTCCTACTCTCC -> CTGAGGCCTCCTACTCTCCT
GTTGTAAGGGGCCGATCTCG -> TTGTAAGGGGCCGATCTCGA
GTCACGGCCTAAATCACCCA -> TCACGGCCTAAATCACCCAA
ACTCTCCTAGTCACGACTCA -> CTCTCCTAGTCACGACTCAA
AGGAAACGAGGTCAAGGTCA -> GGAAACGAGGTCAAGGTCAT
ACACTCCCCGTGGCAACCCA -> CACTCCCCGTGGCAACCCAG
ACTCCCCGTGGCAACCCAGT -> CTCCCCGTGGCAACCCAGTT
ACTGGCCTCCCAGAGCAAAG -> CTGGCCTCCCAGAGCAAAGG
CCGGGATCTCACCTATAGTT -> CGGGATCTCACCTATAGTTA
TCAGCCTAATATCAAATCTA -> CAGCCTAATATCAAATCTAC
AACGTTTTGTCTGAGGCCTC -> ACGTTTTGTCTGAGGCCTCC
ACCTGAGGATTAAAAAAGCA -> CCTGAGGATTAAAAAAGCAT
TCTACAATACGCATGTAAAG -> CTACAATACGCATGTAAAGG
GTAGGTAGCGTAACGTTTTG -> TAGGTAGCGTAACGTTTTGT
CGAGGTCAAGGTCATAGTGT -> GAGGTCAAGGTCATAGTGTA
ATAGTTGTCGGGTGCAGTCA -> TAGTTGTCGGGTGCAGTCAA
CCAGAGCAAAGGAGGAAAGC -> CAGAGCAAAGGAGGAAAGCC
GCAAGGTGAAACGGTATCGC -> CAAGGTGAAACGGTATCGCG
CAACGCTCATACTGGCCTCC -> AACGCTCATACTGGCCTCCC
TCCAGCAAGGTGAAACGGTA -> CCAGCAAGGTGAAACGGTAT
CGGGCAACGCTCGATTGTGT -> GGGCAACGCTCGATTGTGTG
AAAAAGCATTTGAGTCTTTC -> AAAAGCATTTGAGTCTTTCG
AGCGTAACGTTTTGTCTGAG -> GCGTAACGTTTTGTCTGAGG
ACCCTCGAACGAATCTGGAG -> CCCTCGAACGAATCTGGAGC
TATCATTAATCTTTGTTCGG -> ATCATTAATCTTTGTTCGGA
CGAACGAATCTGGAGCGTGA -> GAACGAATCTGGAGCGTGAT
TTTAGTTTGTGCAGATATTA -> TTAGTTTGTGCAGATATTAT
ACGCGACCGACAGCGGCTTA -> CGCGACCGACAGCGGCTTAG
TCATACTGGCCTCCCAGAGC -> CATACTGGCCTCCCAGAGCA
CCGTGGCAACCCAGTTCGCC -> CGTGGCAACCCAGTTCGCCG
GCTTACCATAGCCTAGGCTA -> CTTACCATAGCCTAGGCTAG
ATACCCTTTGTGTATCATTT -> TACCCTTTGTGTATCATTTT
TAGATTAGAATCCTGCATCC -> AGATTAGAATCCTGCATCCC
AGTGTAGGTGGAGCGCTAAA -> GTGTAGGTGGAGCGCTAAAG
GCGGAGCATATAAGCCCCCA -> CGGAGCATATAAGCCCCCAG
TAACGTTTTGTCTGAGGCCT -> AACGTTTTGTCTGAGGCCTC
AACGCTCATACTGGCCTCCC -> ACGCTCATACTGGCCTCCCA
AGGTCAGCCTAATATCAAAT -> GGTCAGCCTAATATCAAATC
TCGGACCCTCGAACGAATCT -> CGGACCCTCGAACGAATCTG
GAACGCTATTTTAGACAGCG -> AACGCTATTTTAGACAGCGT
GGATTACTGTGGTTTCACCA -> GATTACTGTGGTTTCACCAT
GGGATCTCACCTATAGTTAC -> GGATCTCACCTATAGTTACA
CAAAGGAGGAAAGCCGCTGT -> AAAGGAGGAAAGCCGCTGTG
AGTTACACTTTTGTGGCAAC -> GTTACACTTTTGTGGCAACA
AGGCCTCCTACTCTCCTAGT -> GGCCTCCTACTCTCCTAGTC
GGCAACCCAGTTCGCCGAGG -> GCAACCCAGTTCGCCGAGGC
GTCCAGCAAGGTGAAACGGT -> TCCAGCAAGGTGAAACGGTA
CAAATCTACAATACGCATGT -> AAATCTACAATACGCATGTA
GTTTCACCATAGTTGTCGGG -> TTTCACCATAGTTGTCGGGT
TCACTAGTGTGTTCGTGAGA -> CACTAGTGTGTTCGTGAGAT
TCTCCTAGTCACGACTCAAT -> CTCCTAGTCACGACTCAATT
ATAGAGCCCGGGATCTCACC -> TAGAGCCCGGGATCTCACCT
TAGGTGGAGCGCTAAAGAAC -> AGGTGGAGCGCTAAAGAACG
TGGGGACAGATAATTGCGCA -> GGGGACAGATAATTGCGCAT
GCGACCGACAGCGGCTTAGA -> CGACCGACAGCGGCTTAGAC
GTTCGGACCCTCGAACGAAT -> TTCGGACCCTCGAACGAATC
CCGCTTACGGATGGCTTACC -> CGCTTACGGATGGCTTACCA
CAGGAAACGAGGTCAAGGTC -> AGGAAACGAGGTCAAGGTCA
TCTCGAGCGAGTCTTCTTAC -> CTCGAGCGAGTCTTCTTACC
GTTGTCGGGTGCAGTCAAGG -> TTGTCGGGTGCAGTCAAGGC
CCATAGCCTAGGCTAGGACA -> CATAGCCTAGGCTAGGACAG
CTCCCCGTGGCAACCCAGTT -> TCCCCGTGGCAACCCAGTTC
CCTTTGTGTATCATTTTCTG -> CTTTGTGTATCATTTTCTGT
ACGCTCGATTGTGTGCGCCC -> CGCTCGATTGTGTGCGCCCG
AAAGGGCTTTAGTTTGTGCA -> AAGGGCTTTAGTTTGTGCAG
TAAAGTGCTGAGTAGTTTCA -> AAAGTGCTGAGTAGTTTCAT
CGATTATGTCGGGTCCAGCA -> GATTATGTCGGGTCCAGCAA
GTAAGGGGCCGATCTCGAGC -> TAAGGGGCCGATCTCGAGCG
AGGAGGAAAGCCGCTGTGCT -> GGAGGAAAGCCGCTGTGCTA
TGCTAAAGTGCTGAGTAGTT -> GCTAAAGTGCTGAGTAGTTT
CCCGACCTGAATCTATTGGG -> CCGACCTGAATCTATTGGGG
GAGGCTGGTCTCGCTCTACC -> AGGCTGGTCTCGCTCTACCA
CACCTATAGTTACACTTTTG -> ACCTATAGTTACACTTTTGT
AGGTGAAACGGTATCGCGCT -> GGTGAAACGGTATCGCGCTT
TGCGCCCGTTAATTTTCGGT -> GCGCCCGTTAATTTTCGGTT
AAACGAGGTCAAGGTCATAG -> AACGAGGTCAAGGTCATAGT
AAGCCCCCAGCATTCAAAAC -> AGCCCCCAGCATTCAAAACC
TTATGAAGGACGGGCAACGC -> TATGAAGGACGGGCAACGCT
AAATCTACAATACGCATGTA -> AATCTACAATACGCATGTAA
GGTATCGCGCTTCAGCATTC -> GTATCGCGCTTCAGCATTCG
AGCCCGGGATCTCACCTATA -> GCCCGGGATCTCACCTATAG
GCCCGTTAATTTTCGGTTTT -> CCCGTTAATTTTCGGTTTTG
CGACCGACAGCGGCTTAGAC -> GACCGACAGCGGCTTAGACC
ATGTAAAGGGCTTTAGTTTG -> TGTAAAGGGCTTTAGTTTGT
TAATATCAAATCTACAATAC -> AATATCAAATCTACAATACG
TACTGTGGTTTCACCATAGT -> ACTGTGGTTTCACCATAGTT
AAAGCATTTGAGTCTTTCGA -> AAGCATTTGAGTCTTTCGAA
TCGCGCTTCAGCATTCGTTG -> CGCGCTTCAGCATTCGTTGT
AGAATCCTGCATCCCTATTT -> GAATCCTGCATCCCTATTTA
AGGACGGGCAACGCTCGATT -> GGACGGGCAACGCTCGATTG
TGAGTAGTTTCATTGTTGTA -> GAGTAGTTTCATTGTTGTAA
TCATAGTGTAGGTGGAGCGC -> CATAGTGTAGGTGGAGCGCT
ACAGGTCAGCCTAATATCAA -> CAGGTCAGCCTAATATCAAA
GATGATGGGCACCGCTGTTT -> ATGATGGGCACCGCTGTTTA
CCATAGTTGTCGGGTGCAGT -> CATAGTTGTCGGGTGCAGTC
CGTGAGATGATGGGCACCGC -> GTGAGATGATGGGCACCGCT
GAGGTCAAGGTCATAGTGTA -> AGGTCAAGGTCATAGTGTAG
CGGTATCGCGCTTCAGCATT -> GGTATCGCGCTTCAGCATTC
AATCCTGCATCCCTATTTAC -> ATCCTGCATCCCTATTTACT
ATCACCCAATAGAGCCCGGG -> TCACCCAATAGAGCCCGGGA
TGGGCACCGCTGTTTAGGTA -> GGGCACCGCTGTTTAGGTAG
TCAACGCTCATACTGGCCTC -> CAACGCTCATACTGGCCTCC
TTGTGTGCGCCCGTTAATTT -> TGTGTGCGCCCGTTAATTTT
GCATACCCTTTGTGTATCAT -> CATACCCTTTGTGTATCATT
AACCGTCAACGCTCATACTG -> ACCGTCAACGCTCATACTGG
CCTATCATTAATCTTTGTTC -> CTATCATTAATCTTTGTTCG
CTATTTACTGTCACGGCCTA -> TATTTACTGTCACGGCCTAA
GTCAAGGTCATAGTGTAGGT -> TCAAGGTCATAGTGTAGGTG
TCCTGCATCCCTATTTACTG -> CCTGCATCCCTATTTACTGT
TAGTTTCATTGTTGTAAGGG -> AGTTTCATTGTTGTAAGGGG
TTAGACCGCTGAGGCACTCC -> TAGACCGCTGAGGCACTCCG
TTCGAACCGTCAACGCTCAT -> TCGAACCGTCAACGCTCATA
AAAGGAGGAAAGCCGCTGTG -> AAGGAGGAAAGCCGCTGTGC
GGAGCTGTACCTAGATTAGA -> GAGCTGTACCTAGATTAGAA
TTTACACTCCCCGTGGCAAC -> TTACACTCCCCGTGGCAACC
ATCTTTGTTCGGACCCTCGA -> TCTTTGTTCGGACCCTCGAA
CTTACCATAGCCTAGGCTAG -> TTACCATAGCCTAGGCTAGG
GCATTCGTTGTACCGAGCAA -> CATTCGTTGTACCGAGCAAC
ACTGTGGTTTCACCATAGTT -> CTGTGGTTTCACCATAGTTG
AGCGGCTTAGACCGCTGAGG -> GCGGCTTAGACCGCTGAGGC
TGTGGCAACAGGAAACGAGG -> GTGGCAACAGGAAACGAGGT
TTGTTCGGACCCTCGAACGA -> TGTTCGGACCCTCGAACGAA
CATTTTCTGTCGATTATGTC -> ATTTTCTGTCGATTATGTCG
CGATTGTGTGCGCCCGTTAA -> GATTGTGTGCGCCCGTTAAT
TGTCACGGCCTAAATCACCC -> GTCACGGCCTAAATCACCCA
GTGTAGGTGGAGCGCTAAAG -> TGTAGGTGGAGCGCTAAAGA
GAGGCACTCCGAATACCCCG -> AGGCACTCCGAATACCCCGA
TGTGTTCGTGAGATGATGGG -> GTGTTCGTGAGATGATGGGC
CGCCCGTTAATTTTCGGTTT -> GCCCGTTAATTTTCGGTTTT
CCTGAATCTATTGGGGACAG -> CTGAATCTATTGGGGACAGA
CGCTATTTTAGACAGCGTCG -> GCTATTTTAGACAGCGTCGC
GACGTGACCATCTGAGATTT -> ACGTGACCATCTGAGATTTG
GCCTCCTACTCTCCTAGTCA -> CCTCCTACTCTCCTAGTCAC
GCCTCTAGAATCACTAGTGT -> CCTCTAGAATCACTAGTGTG
GAAAGCCGCTGTGCTAAAGT -> AAAGCCGCTGTGCTAAAGTG
TTTGGGCCTCTAGAATCACT -> TTGGGCCTCTAGAATCACTA
CCTGAGGATTAAAAAAGCAT -> CTGAGGATTAAAAAAGCATT
TGGCTTACCATAGCCTAGGC -> GGCTTACCATAGCCTAGGCT
TCAAGGCTTGATCCGGTGGA -> CAAGGCTTGATCCGGTGGAA
AGGTGGAGCGCTAAAGAACG -> GGTGGAGCGCTAAAGAACGC
GTTTACGGATTACTGTGGTT -> TTTACGGATTACTGTGGTTT
AGGAAAGCCGCTGTGCTAAA -> GGAAAGCCGCTGTGCTAAAG
TAAGCCCCCAGCATTCAAAA -> AAGCCCCCAGCATTCAAAAC
AATTGCGCATACCCTTTGTG -> ATTGCGCATACCCTTTGTGT
TGGGCCTCTAGAATCACTAG -> GGGCCTCTAGAATCACTAGT
TGTCGATTATGTCGGGTCCA -> GTCGATTATGTCGGGTCCAG
CACTCCGAATACCCCGACCT -> ACTCCGAATACCCCGACCTG
AAATGGAGCTGTACCTAGAT -> AATGGAGCTGTACCTAGATT
GGTCAAGGTCATAGTGTAGG -> GTCAAGGTCATAGTGTAGGT
TATGAAGGACGGGCAACGCT -> ATGAAGGACGGGCAACGCTC
CTTGATCCGGTGGAAACATT -> TTGATCCGGTGGAAACATTA
GGAGCGTGATGCGGAGCATA -> GAGCGTGATGCGGAGCATAT
CCCTATTTACTGTCACGGCC -> CCTATTTACTGTCACGGCCT
ATCAAATCTACAATACGCAT -> TCAAATCTACAATACGCATG
AGCAAAGGAGGAAAGCCGCT -> GCAAAGGAGGAAAGCCGCTG
GAGCCCGGGATCTCACCTAT -> AGCCCGGGATCTCACCTATA
TTGTGGCAACAGGAAACGAG -> TGTGGCAACAGGAAACGAGG
GCTAAACGCGTTTACGGATT -> CTAAACGCGTTTACGGATTA
TTTAGGTAGGTAGCGTAACG -> TTAGGTAGGTAGCGTAACGT
GTCAGCCTAATATCAAATCT -> TCAGCCTAATATCAAATCTA
CGTAACGTTTTGTCTGAGGC -> GTAACGTTTTGTCTGAGGCC
TTGTACCGAGCAACCGCTTA -> TGTACCGAGCAACCGCTTAC
AACGAATCTGGAGCGTGATG -> ACGAATCTGGAGCGTGATGC
CGGATTACTGTGGTTTCACC -> GGATTACTGTGGTTTCACCA
GGATGGCTTACCATAGCCTA -> GATGGCTTACCATAGCCTAG
TTAGGTAGGTAGCGTAACGT -> TAGGTAGGTAGCGTAACGTT
TACCCCGACCTGAATCTATT -> ACCCCGACCTGAATCTATTG
AACAACCTATCATTAATCTT -> ACAACCTATCATTAATCTTT
AGATATTATGAACAACCTAT -> GATATTATGAACAACCTATC
GGGGCCGATCTCGAGCGAGT -> GGGCCGATCTCGAGCGAGTC
GTAGTTTCATTGTTGTAAGG -> TAGTTTCATTGTTGTAAGGG
TCGTTGTACCGAGCAACCGC -> CGTTGTACCGAGCAACCGCT
CGTGATGCGGAGCATATAAG -> GTGATGCGGAGCATATAAGC
TCACCATAGTTGTCGGGTGC -> CACCATAGTTGTCGGGTGCA
TGGTTTCACCATAGTTGTCG -> GGTTTCACCATAGTTGTCGG
GGGCCTCTAGAATCACTAGT -> GGCCTCTAGAATCACTAGTG
CGACCTGAATCTATTGGGGA -> GACCTGAATCTATTGGGGAC
CTTAGACCGCTGAGGCACTC -> TTAGACCGCTGAGGCACTCC
TGGAGCGCTAAAGAACGCTA -> GGAGCGCTAAAGAACGCTAT
TTGACGTGACCATCTGAGAT -> TGACGTGACCATCTGAGATT
CTTTGTGTATCATTTTCTGT -> TTTGTGTATCATTTTCTGTC
GAATCCTGCATCCCTATTTA -> AATCCTGCATCCCTATTTAC
TTGTCGGGTGCAGTCAAGGC -> TGTCGGGTGCAGTCAAGGCT
TGTACCGAGCAACCGCTTAC -> GTACCGAGCAACCGCTTACG
CATCCCTATTTACTGTCACG -> ATCCCTATTTACTGTCACGG
AGCATTCAAAACCTGAGGAT -> GCATTCAAAACCTGAGGATT
TAGCCTAGGCTAGGACAGGT -> AGCCTAGGCTAGGACAGGTC
ACTGTCACGGCCTAAATCAC -> CTGTCACGGCCTAAATCACC
TAGGTAGCGTAACGTTTTGT -> AGGTAGCGTAACGTTTTGTC
TAGACCGCTGAGGCACTCCG -> AGACCGCTGAGGCACTCCGA
TAAAGGGCTTTAGTTTGTGC -> AAAGGGCTTTAGTTTGTGCA
TTCGTTGTACCGAGCAACCG -> TCGTTGTACCGAGCAACCGC
GCATTCAAAACCTGAGGATT -> CATTCAAAACCTGAGGATTA
CCTCCCAGAGCAAAGGAGGA -> CTCCCAGAGCAAAGGAGGAA
TGGCAACCCAGTTCGCCGAG -> GGCAACCCAGTTCGCCGAGG
CGCTGTGCTAAAGTGCTGAG -> GCTGTGCTAAAGTGCTGAGT
GGAGCGCTAAAGAACGCTAT -> GAGCGCTAAAGAACGCTATT
CCTAGTCACGACTCAATTTA -> CTAGTCACGACTCAATTTAC
AAGGGGCCGATCTCGAGCGA -> AGGGGCCGATCTCGAGCGAG
CTGAGGCACTCCGAATACCC -> TGAGGCACTCCGAATACCCC
CCAGCGAATACGCGACCGAC -> CAGCGAATACGCGACCGACA
ACCCCGACCTGAATCTATTG -> CCCCGACCTGAATCTATTGG
ATGTCGGGTCCAGCAAGGTG -> TGTCGGGTCCAGCAAGGTGA
GAATCACTAGTGTGTTCGTG -> AATCACTAGTGTGTTCGTGA
CATTCGTTGTACCGAGCAAC -> ATTCGTTGTACCGAGCAACC
AATCTATTGGGGACAGATAA -> ATCTATTGGGGACAGATAAT
AACAGGAAACGAGGTCAAGG -> ACAGGAAACGAGGTCAAGGT
ATTTACTGTCACGGCCTAAA -> TTTACTGTCACGGCCTAAAT
CTTTCGAACCGTCAACGCTC -> TTTCGAACCGTCAACGCTCA
AGGTCATAGTGTAGGTGGAG -> GGTCATAGTGTAGGTGGAGC
GGCTGGTCTCGCTCTACCAG -> GCTGGTCTCGCTCTACCAGC
TTTGTTCGGACCCTCGAACG -> TTGTTCGGACCCTCGAACGA
TAATTTTCGGTTTTGACGTG -> AATTTTCGGTTTTGACGTGA
CCCGGGATCTCACCTATAGT -> CCGGGATCTCACCTATAGTT
TAGAGCCCGGGATCTCACCT -> AGAGCCCGGGATCTCACCTA
TGAGTCTTTCGAACCGTCAA -> GAGTCTTTCGAACCGTCAAC
CTGGAGCGTGATGCGGAGCA -> TGGAGCGTGATGCGGAGCAT
GGAAACATTAACAGCCCTTA -> GAAACATTAACAGCCCTTAT
ATTCAAAACCTGAGGATTAA -> TTCAAAACCTGAGGATTAAA
GAGCATATAAGCCCCCAGCA -> AGCATATAAGCCCCCAGCAT
CCCCGACCTGAATCTATTGG -> CCCGACCTGAATCTATTGGG
AACGCTCGATTGTGTGCGCC -> ACGCTCGATTGTGTGCGCCC
TCCTACTCTCCTAGTCACGA -> CCTACTCTCCTAGTCACGAC
ACATTAACAGCCCTTATGAA -> CATTAACAGCCCTTATGAAG
AATAGAGCCCGGGATCTCAC -> ATAGAGCCCGGGATCTCACC
ACGGTATCGCGCTTCAGCAT -> CGGTATCGCGCTTCAGCATT
GCCGCTGTGCTAAAGTGCTG -> CCGCTGTGCTAAAGTGCTGA
TGAGATGATGGGCACCGCTG -> GAGATGATGGGCACCGCTGT
ATAAGCCCCCAGCATTCAAA -> TAAGCCCCCAGCATTCAAAA
GGAGCATATAAGCCCCCAGC -> GAGCATATAAGCCCCCAGCA
GATAATTGCGCATACCCTTT -> ATAATTGCGCATACCCTTTG
TCTGGAGCGTGATGCGGAGC -> CTGGAGCGTGATGCGGAGCA
TCGTGAGATGATGGGCACCG -> CGTGAGATGATGGGCACCGC
TGATGGGCACCGCTGTTTAG -> GATGGGCACCGCTGTTTAGG
GCGTTTACGGATTACTGTGG -> CGTTTACGGATTACTGTGGT
GATTATGTCGGGTCCAGCAA -> ATTATGTCGGGTCCAGCAAG
ACCGTCAACGCTCATACTGG -> CCGTCAACGCTCATACTGGC
AAGGTCATAGTGTAGGTGGA -> AGGTCATAGTGTAGGTGGAG
ACCGCTGTTTAGGTAGGTAG -> CCGCTGTTTAGGTAGGTAGC
CTCCTAGTCACGACTCAATT -> TCCTAGTCACGACTCAATTT
GCGCATACCCTTTGTGTATC -> CGCATACCCTTTGTGTATCA
CCCTTTGTGTATCATTTTCT -> CCTTTGTGTATCATTTTCTG
TAGTTGTCGGGTGCAGTCAA -> AGTTGTCGGGTGCAGTCAAG
GCCGATCTCGAGCGAGTCTT -> CCGATCTCGAGCGAGTCTTC
GTGATGCGGAGCATATAAGC -> TGATGCGGAGCATATAAGCC
CAAGGTCATAGTGTAGGTGG -> AAGGTCATAGTGTAGGTGGA
CCGCTGAGGCACTCCGAATA -> CGCTGAGGCACTCCGAATAC
TTAACAGCCCTTATGAAGGA -> TAACAGCCCTTATGAAGGAC
TCGGGTCCAGCAAGGTGAAA -> CGGGTCCAGCAAGGTGAAAC
GCAACGCTCGATTGTGTGCG -> CAACGCTCGATTGTGTGCGC
TAAAGAACGCTATTTTAGAC -> AAAGAACGCTATTTTAGACA
ACCTATAGTTACACTTTTGT -> CCTATAGTTACACTTTTGTG
GTCTTTCGAACCGTCAACGC -> TCTTTCGAACCGTCAACGCT
AAACGCGTTTACGGATTACT -> AACGCGTTTACGGATTACTG
GCTAAAGAACGCTATTTTAG -> CTAAAGAACGCTATTTTAGA
ACGGATGGCTTACCATAGCC -> CGGATGGCTTACCATAGCCT
AATCTGGAGCGTGATGCGGA -> ATCTGGAGCGTGATGCGGAG
CCCCCAGCATTCAAAACCTG -> CCCCAGCATTCAAAACCTGA
TGAAACGGTATCGCGCTTCA -> GAAACGGTATCGCGCTTCAG
TCTACCAGCGAATACGCGAC -> CTACCAGCGAATACGCGACC
CAAGGCTTGATCCGGTGGAA -> AAGGCTTGATCCGGTGGAAA
AGATTAGAATCCTGCATCCC -> GATTAGAATCCTGCATCCCT
TGAGATTTGGGCCTCTAGAA -> GAGATTTGGGCCTCTAGAAT
GGCTAGGACAGGTCAGCCTA -> GCTAGGACAGGTCAGCCTAA
CTTCAGCATTCGTTGTACCG -> TTCAGCATTCGTTGTACCGA
GTTTCATTGTTGTAAGGGGC -> TTTCATTGTTGTAAGGGGCC
CGACTCAATTTACACTCCCC -> GACTCAATTTACACTCCCCG
TGCTGAGTAGTTTCATTGTT -> GCTGAGTAGTTTCATTGTTG
AACCTGAGGATTAAAAAAGC -> ACCTGAGGATTAAAAAAGCA
CAATAGAGCCCGGGATCTCA -> AATAGAGCCCGGGATCTCAC
TTTCGGTTTTGACGTGACCA -> TTCGGTTTTGACGTGACCAT
CCTAAATCACCCAATAGAGC -> CTAAATCACCCAATAGAGCC
CCCCAGCATTCAAAACCTGA -> CCCAGCATTCAAAACCTGAG
CAGCGTCGCTAAACGCGTTT -> AGCGTCGCTAAACGCGTTTA
AGTCACGACTCAATTTACAC -> GTCACGACTCAATTTACACT
GATCTCGAGCGAGTCTTCTT -> ATCTCGAGCGAGTCTTCTTA
GTCGGGTCCAGCAAGGTGAA -> TCGGGTCCAGCAAGGTGAAA
TGGTCTCGCTCTACCAGCGA -> GGTCTCGCTCTACCAGCGAA
GCATGTAAAGGGCTTTAGTT -> CATGTAAAGGGCTTTAGTTT
TACCCTTTGTGTATCATTTT -> ACCCTTTGTGTATCATTTTC
GGGTCCAGCAAGGTGAAACG -> GGTCCAGCAAGGTGAAACGG
TGTGTGCGCCCGTTAATTTT -> GTGTGCGCCCGTTAATTTTC
CAGCATTCAAAACCTGAGGA -> AGCATTCAAAACCTGAGGAT
GCTATTTTAGACAGCGTCGC -> CTATTTTAGACAGCGTCGCT
TCGGTTTTGACGTGACCATC -> CGGTTTTGACGTGACCATCT
TACACTCCCCGTGGCAACCC -> ACACTCCCCGTGGCAACCCA
AGAACGCTATTTTAGACAGC -> GAACGCTATTTTAGACAGCG
AGGATTAAAAAAGCATTTGA -> GGATTAAAAAAGCATTTGAG
GTGTATCATTTTCTGTCGAT -> TGTATCATTTTCTGTCGATT
ATGGAGCTGTACCTAGATTA -> TGGAGCTGTACCTAGATTAG
AGCAAGGTGAAACGGTATCG -> GCAAGGTGAAACGGTATCGC
AATATCAAATCTACAATACG -> ATATCAAATCTACAATACGC
CCTATTTACTGTCACGGCCT -> CTATTTACTGTCACGGCCTA
GCCTAGGCTAGGACAGGTCA -> CCTAGGCTAGGACAGGTCAG
AACCGCTTACGGATGGCTTA -> ACCGCTTACGGATGGCTTAC
ACGGGCAACGCTCGATTGTG -> CGGGCAACGCTCGATTGTGT
CCAGTTCGCCGAGGCTGGTC -> CAGTTCGCCGAGGCTGGTCT
ATCCGGTGGAAACATTAACA -> TCCGGTGGAAACATTAACAG
TCTGAGATTTGGGCCTCTAG -> CTGAGATTTGGGCCTCTAGA
CGCATGTAAAGGGCTTTAGT -> GCATGTAAAGGGCTTTAGTT
GAACAACCTATCATTAATCT -> AACAACCTATCATTAATCTT
GCTAGGACAGGTCAGCCTAA -> CTAGGACAGGTCAGCCTAAT
AATCACTAGTGTGTTCGTGA -> ATCACTAGTGTGTTCGTGAG
GCCGAGCTAAATGGAGCTGT -> CCGAGCTAAATGGAGCTGTA
ACCCAGTTCGCCGAGGCTGG -> CCCAGTTCGCCGAGGCTGGT
AAAGAACGCTATTTTAGACA -> AAGAACGCTATTTTAGACAG
CGGTTTTGACGTGACCATCT -> GGTTTTGACGTGACCATCTG
CGACAGCGGCTTAGACCGCT -> GACAGCGGCTTAGACCGCTG
GTACCTAGATTAGAATCCTG -> TACCTAGATTAGAATCCTGC
GTGGCAACAGGAAACGAGGT -> TGGCAACAGGAAACGAGGTC
GGAGGAAAGCCGCTGTGCTA -> GAGGAAAGCCGCTGTGCTAA
ATTATGTCGGGTCCAGCAAG -> TTATGTCGGGTCCAGCAAGG
TCTATTGGGGACAGATAATT -> CTATTGGGGACAGATAATTG
CATAGTTGTCGGGTGCAGTC -> ATAGTTGTCGGGTGCAGTCA
CCCTTATGAAGGACGGGCAA -> CCTTATGAAGGACGGGCAAC
CGCTTCAGCATTCGTTGTAC -> GCTTCAGCATTCGTTGTACC
GGCACTCCGAATACCCCGAC -> GCACTCCGAATACCCCGACC
AAGGGCTTTAGTTTGTGCAG -> AGGGCTTTAGTTTGTGCAGA
CTCCGAATACCCCGACCTGA -> TCCGAATACCCCGACCTGAA
TGTTCGTGAGATGATGGGCA -> GTTCGTGAGATGATGGGCAC
CATACCCTTTGTGTATCATT -> ATACCCTTTGTGTATCATTT
TCAATTTACACTCCCCGTGG -> CAATTTACACTCCCCGTGGC
AGTCAAGGCTTGATCCGGTG -> GTCAAGGCTTGATCCGGTGG
AGGACAGGTCAGCCTAATAT -> GGACAGGTCAGCCTAATATC
CCTAGATTAGAATCCTGCAT -> CTAGATTAGAATCCTGCATC
CTGAGGCCTCCTACTCTCCT -> TGAGGCCTCCTACTCTCCTA
GTCAAGGCTTGATCCGGTGG -> TCAAGGCTTGATCCGGTGGA
CTTATGAAGGACGGGCAACG -> TTATGAAGGACGGGCAACGC
GAGGAAAGCCGCTGTGCTAA -> AGGAAAGCCGCTGTGCTAAA
CGGTGGAAACATTAACAGCC -> GGTGGAAACATTAACAGCCC
AAGAACGCTATTTTAGACAG -> AGAACGCTATTTTAGACAGC
TTTGTGCAGATATTATGAAC -> TTGTGCAGATATTATGAACA
GCCCTTATGAAGGACGGGCA -> CCCTTATGAAGGACGGGCAA
AACCTATCATTAATCTTTGT -> ACCTATCATTAATCTTTGTT
AGGGCTTTAGTTTGTGCAGA -> GGGCTTTAGTTTGTGCAGAT
GAGTAGTTTCATTGTTGTAA -> AGTAGTTTCATTGTTGTAAG
GGCTTGATCCGGTGGAAACA -> GCTTGATCCGGTGGAAACAT
GAACCGTCAACGCTCATACT -> AACCGTCAACGCTCATACTG
TCACCCAATAGAGCCCGGGA -> CACCCAATAGAGCCCGGGAT
AAGTGCTGAGTAGTTTCATT -> AGTGCTGAGTAGTTTCATTG
TGTGCAGATATTATGAACAA -> GTGCAGATATTATGAACAAC
GTAGCGTAACGTTTTGTCTG -> TAGCGTAACGTTTTGTCTGA
CAGCGGCTTAGACCGCTGAG -> AGCGGCTTAGACCGCTGAGG
TACGCATGTAAAGGGCTTTA -> ACGCATGTAAAGGGCTTTAG
ATCCTGCATCCCTATTTACT -> TCCTGCATCCCTATTTACTG
GCCGAGGCTGGTCTCGCTCT -> CCGAGGCTGGTCTCGCTCTA
GTAGGTGGAGCGCTAAAGAA -> TAGGTGGAGCGCTAAAGAAC
GTCATAGTGTAGGTGGAGCG -> TCATAGTGTAGGTGGAGCGC
TCGCCGAGGCTGGTCTCGCT -> CGCCGAGGCTGGTCTCGCTC
CCCAGAGCAAAGGAGGAAAG -> CCAGAGCAAAGGAGGAAAGC
GCTTCAGCATTCGTTGTACC -> CTTCAGCATTCGTTGTACCG
GGTTTTGACGTGACCATCTG -> GTTTTGACGTGACCATCTGA
CCGTTAATTTTCGGTTTTGA -> CGTTAATTTTCGGTTTTGAC
ACGTGACCATCTGAGATTTG -> CGTGACCATCTGAGATTTGG
GGTTTCACCATAGTTGTCGG -> GTTTCACCATAGTTGTCGGG
TCGGGTGCAGTCAAGGCTTG -> CGGGTGCAGTCAAGGCTTGA
TGTGCGCCCGTTAATTTTCG -> GTGCGCCCGTTAATTTTCGG
CATTAACAGCCCTTATGAAG -> ATTAACAGCCCTTATGAAGG
GTGTGCGCCCGTTAATTTTC -> TGTGCGCCCGTTAATTTTCG
GCGGCTTAGACCGCTGAGGC -> CGGCTTAGACCGCTGAGGCA
CTAAACGCGTTTACGGATTA -> TAAACGCGTTTACGGATTAC
AGCATTCGTTGTACCGAGCA -> GCATTCGTTGTACCGAGCAA
GGTCATAGTGTAGGTGGAGC -> GTCATAGTGTAGGTGGAGCG
GACCGACAGCGGCTTAGACC -> ACCGACAGCGGCTTAGACCG
ATTGGGGACAGATAATTGCG -> TTGGGGACAGATAATTGCGC
TAGTTACACTTTTGTGGCAA -> AGTTACACTTTTGTGGCAAC
CTAGGACAGGTCAGCCTAAT -> TAGGACAGGTCAGCCTAATA
TTCGGACCCTCGAACGAATC -> TCGGACCCTCGAACGAATCT
TAGTGTAGGTGGAGCGCTAA -> AGTGTAGGTGGAGCGCTAAA
TTTGAGTCTTTCGAACCGTC -> TTGAGTCTTTCGAACCGTCA
CCGTCAACGCTCATACTGGC -> CGTCAACGCTCATACTGGCC
GTGAAACGGTATCGCGCTTC -> TGAAACGGTATCGCGCTTCA
CGTGACCATCTGAGATTTGG -> GTGACCATCTGAGATTTGGG
TGCGGAGCATATAAGCCCCC -> GCGGAGCATATAAGCCCCCA
ACCCTTTGTGTATCATTTTC -> CCCTTTGTGTATCATTTTCT
ATACCCCGACCTGAATCTAT -> TACCCCGACCTGAATCTATT
TTGTCTGAGGCCTCCTACTC -> TGTCTGAGGCCTCCTACTCT
AGATGATGGGCACCGCTGTT -> GATGATGGGCACCGCTGTTT
ACCGAGCAACCGCTTACGGA -> CCGAGCAACCGCTTACGGAT
AGCAACCGCTTACGGATGGC -> GCAACCGCTTACGGATGGCT
CCCGTGGCAACCCAGTTCGC -> CCGTGGCAACCCAGTTCGCC
CTATTTTAGACAGCGTCGCT -> TATTTTAGACAGCGTCGCTA
GAATCTGGAGCGTGATGCGG -> AATCTGGAGCGTGATGCGGA
CTCGAACGAATCTGGAGCGT -> TCGAACGAATCTGGAGCGTG
GCAACCCAGTTCGCCGAGGC -> CAACCCAGTTCGCCGAGGCT
CTACAATACGCATGTAAAGG -> TACAATACGCATGTAAAGGG
ACCTATCATTAATCTTTGTT -> CCTATCATTAATCTTTGTTC
TATTATGAACAACCTATCAT -> ATTATGAACAACCTATCATT
ACGCTCATACTGGCCTCCCA -> CGCTCATACTGGCCTCCCAG
TTACACTTTTGTGGCAACAG -> TACACTTTTGTGGCAACAGG
CCGACAGCGGCTTAGACCGC -> CGACAGCGGCTTAGACCGCT
AAAAAAGCATTTGAGTCTTT -> AAAAAGCATTTGAGTCTTTC
CAAGGTGAAACGGTATCGCG -> AAGGTGAAACGGTATCGCGC
TACTCTCCTAGTCACGACTC -> ACTCTCCTAGTCACGACTCA
GTATCGCGCTTCAGCATTCG -> TATCGCGCTTCAGCATTCGT
AGACCGCTGAGGCACTCCGA -> GACCGCTGAGGCACTCCGAA
TTCAAAACCTGAGGATTAAA -> TCAAAACCTGAGGATTAAAA
TGGAGCTGTACCTAGATTAG -> GGAGCTGTACCTAGATTAGA
TGAATCTATTGGGGACAGAT -> GAATCTATTGGGGACAGATA
ACTTTTGTGGCAACAGGAAA -> CTTTTGTGGCAACAGGAAAC
GTAACGTTTTGTCTGAGGCC -> TAACGTTTTGTCTGAGGCCT
TGACCATCTGAGATTTGGGC -> GACCATCTGAGATTTGGGCC
TGTCTGAGGCCTCCTACTCT -> GTCTGAGGCCTCCTACTCTC
TACCGAGCAACCGCTTACGG -> ACCGAGCAACCGCTTACGGA
GGCCTCTAGAATCACTAGTG -> GCCTCTAGAATCACTAGTGT
GGATCTCACCTATAGTTACA -> GATCTCACCTATAGTTACAC
ATCTCGAGCGAGTCTTCTTA -> TCTCGAGCGAGTCTTCTTAC
GCAAAGGAGGAAAGCCGCTG -> CAAAGGAGGAAAGCCGCTGT
ATTAATCTTTGTTCGGACCC -> TTAATCTTTGTTCGGACCCT
ATTTGGGCCTCTAGAATCAC -> TTTGGGCCTCTAGAATCACT
TTTTAGACAGCGTCGCTAAA -> TTTAGACAGCGTCGCTAAAC
AGGCTAGGACAGGTCAGCCT -> GGCTAGGACAGGTCAGCCTA
CACCATAGTTGTCGGGTGCA -> ACCATAGTTGTCGGGTGCAG
CAACCGCTTACGGATGGCTT -> AACCGCTTACGGATGGCTTA
TACCATAGCCTAGGCTAGGA -> ACCATAGCCTAGGCTAGGAC
GACCTGAATCTATTGGGGAC -> ACCTGAATCTATTGGGGACA
CACTCCCCGTGGCAACCCAG -> ACTCCCCGTGGCAACCCAGT
CAACGCTCGATTGTGTGCGC -> AACGCTCGATTGTGTGCGCC
AAGCATTTGAGTCTTTCGAA -> AGCATTTGAGTCTTTCGAAC
CGAACCGTCAACGCTCATAC -> GAACCGTCAACGCTCATACT
TAAGGGGCCGATCTCGAGCG -> AAGGGGCCGATCTCGAGCGA
CTGTCACGGCCTAAATCACC -> TGTCACGGCCTAAATCACCC
AGGTAGGTAGCGTAACGTTT -> GGTAGGTAGCGTAACGTTTT
GCATTTGAGTCTTTCGAACC -> CATTTGAGTCTTTCGAACCG
GTGGTTTCACCATAGTTGTC -> TGGTTTCACCATAGTTGTCG
ATCACTAGTGTGTTCGTGAG -> TCACTAGTGTGTTCGTGAGA
TAAACGCGTTTACGGATTAC -> AAACGCGTTTACGGATTACT
GGCCTCCCAGAGCAAAGGAG -> GCCTCCCAGAGCAAAGGAGG
ACAGGAAACGAGGTCAAGGT -> CAGGAAACGAGGTCAAGGTC
GCTTAGACCGCTGAGGCACT -> CTTAGACCGCTGAGGCACTC
TTAATCTTTGTTCGGACCCT -> TAATCTTTGTTCGGACCCTC
ATTCGTTGTACCGAGCAACC -> TTCGTTGTACCGAGCAACCG
CGGGTCCAGCAAGGTGAAAC -> GGGTCCAGCAAGGTGAAACG
ATTAGAATCCTGCATCCCTA -> TTAGAATCCTGCATCCCTAT
GGTCTCGCTCTACCAGCGAA -> GTCTCGCTCTACCAGCGAAT
TCTAGAATCACTAGTGTGTT -> CTAGAATCACTAGTGTGTTC
GATTTGGGCCTCTAGAATCA -> ATTTGGGCCTCTAGAATCAC
CAGGTCAGCCTAATATCAAA -> AGGTCAGCCTAATATCAAAT
GTTTGTGCAGATATTATGAA -> TTTGTGCAGATATTATGAAC
TATAAGCCCCCAGCATTCAA -> ATAAGCCCCCAGCATTCAAA
CATAGCCTAGGCTAGGACAG -> ATAGCCTAGGCTAGGACAGG
TAGCGTAACGTTTTGTCTGA -> AGCGTAACGTTTTGTCTGAG
GACCGCTGAGGCACTCCGAA -> ACCGCTGAGGCACTCCGAAT
AAAACCTGAGGATTAAAAAA -> AAACCTGAGGATTAAAAAAG
CACTTTTGTGGCAACAGGAA -> ACTTTTGTGGCAACAGGAAA
ATAGTGTAGGTGGAGCGCTA -> TAGTGTAGGTGGAGCGCTAA
CTGTTTAGGTAGGTAGCGTA -> TGTTTAGGTAGGTAGCGTAA
TGATGCGGAGCATATAAGCC -> GATGCGGAGCATATAAGCCC
GGGCCGATCTCGAGCGAGTC -> GGCCGATCTCGAGCGAGTCT
GAAGGACGGGCAACGCTCGA -> AAGGACGGGCAACGCTCGAT
GATGGCTTACCATAGCCTAG -> ATGGCTTACCATAGCCTAGG
GCTGTTTAGGTAGGTAGCGT -> CTGTTTAGGTAGGTAGCGTA
TGTGCTAAAGTGCTGAGTAG -> GTGCTAAAGTGCTGAGTAGT
TTGGGGACAGATAATTGCGC -> TGGGGACAGATAATTGCGCA
CACGGCCTAAATCACCCAAT -> ACGGCCTAAATCACCCAATA
CGAATACCCCGACCTGAATC -> GAATACCCCGACCTGAATCT
CTCATACTGGCCTCCCAGAG -> TCATACTGGCCTCCCAGAGC
AGCCCTTATGAAGGACGGGC -> GCCCTTATGAAGGACGGGCA
GTTACACTTTTGTGGCAACA -> TTACACTTTTGTGGCAACAG
ATTATGAACAACCTATCATT -> TTATGAACAACCTATCATTA
ACAATACGCATGTAAAGGGC -> CAATACGCATGTAAAGGGCT
TAGGACAGGTCAGCCTAATA -> AGGACAGGTCAGCCTAATAT
CCGACCTGAATCTATTGGGG -> CGACCTGAATCTATTGGGGA
GTCTCGCTCTACCAGCGAAT -> TCTCGCTCTACCAGCGAATA
ACGGCCTAAATCACCCAATA -> CGGCCTAAATCACCCAATAG
ATTTTCTGTCGATTATGTCG -> TTTTCTGTCGATTATGTCGG
CGCGCTTCAGCATTCGTTGT -> GCGCTTCAGCATTCGTTGTA
TTAATTTTCGGTTTTGACGT -> TAATTTTCGGTTTTGACGTG
TTAAAAAAGCATTTGAGTCT -> TAAAAAAGCATTTGAGTCTT
ACCATAGTTGTCGGGTGCAG -> CCATAGTTGTCGGGTGCAGT
ACACTTTTGTGGCAACAGGA -> CACTTTTGTGGCAACAGGAA
TAGTGTGTTCGTGAGATGAT -> AGTGTGTTCGTGAGATGATG
AGCGAATACGCGACCGACAG -> GCGAATACGCGACCGACAGC
GGTGGAGCGCTAAAGAACGC -> GTGGAGCGCTAAAGAACGCT
TCATTTTCTGTCGATTATGT -> CATTTTCTGTCGATTATGTC
AATTTTCGGTTTTGACGTGA -> ATTTTCGGTTTTGACGTGAC
CGAGCGAGTCTTCTTACCTC -> GAGCGAGTCTTCTTACCTCT
CTGAGATTTGGGCCTCTAGA -> TGAGATTTGGGCCTCTAGAA
ACGCTATTTTAGACAGCGTC -> CGCTATTTTAGACAGCGTCG
CCTCCTACTCTCCTAGTCAC -> CTCCTACTCTCCTAGTCACG
TTCGCCGAGGCTGGTCTCGC -> TCGCCGAGGCTGGTCTCGCT
CCCTCGAACGAATCTGGAGC -> CCTCGAACGAATCTGGAGCG
ACTAGTGTGTTCGTGAGATG -> CTAGTGTGTTCGTGAGATGA
AGATTTGGGCCTCTAGAATC -> GATTTGGGCCTCTAGAATCA
CTATCATTAATCTTTGTTCG -> TATCATTAATCTTTGTTCGG
TTTCATTGTTGTAAGGGGCC -> TTCATTGTTGTAAGGGGCCG
GTTGTACCGAGCAACCGCTT -> TTGTACCGAGCAACCGCTTA
AAAAGCATTTGAGTCTTTCG -> AAAGCATTTGAGTCTTTCGA
CGCTGAGGCACTCCGAATAC -> GCTGAGGCACTCCGAATACC
GGTAGGTAGCGTAACGTTTT -> GTAGGTAGCGTAACGTTTTG
TAAAAAAGCATTTGAGTCTT -> AAAAAAGCATTTGAGTCTTT
CTGTCGATTATGTCGGGTCC -> TGTCGATTATGTCGGGTCCA
CCGAGGCTGGTCTCGCTCTA -> CGAGGCTGGTCTCGCTCTAC
ATATCAAATCTACAATACGC -> TATCAAATCTACAATACGCA
GTGGAGCGCTAAAGAACGCT -> TGGAGCGCTAAAGAACGCTA
TGTTGTAAGGGGCCGATCTC -> GTTGTAAGGGGCCGATCTCG
ATGAAGGACGGGCAACGCTC -> TGAAGGACGGGCAACGCTCG
GTCGCTAAACGCGTTTACGG -> TCGCTAAACGCGTTTACGGA
TTGGGCCTCTAGAATCACTA -> TGGGCCTCTAGAATCACTAG
TCCCAGAGCAAAGGAGGAAA -> CCCAGAGCAAAGGAGGAAAG
TTTGTGTATCATTTTCTGTC -> TTGTGTATCATTTTCTGTCG
CGTTTACGGATTACTGTGGT -> GTTTACGGATTACTGTGGTT
TAGACAGCGTCGCTAAACGC -> AGACAGCGTCGCTAAACGCG
CTATAGTTACACTTTTGTGG -> TATAGTTACACTTTTGTGGC
AAGGAGGAAAGCCGCTGTGC -> AGGAGGAAAGCCGCTGTGCT
GATCTCACCTATAGTTACAC -> ATCTCACCTATAGTTACACT
AGTTTGTGCAGATATTATGA -> GTTTGTGCAGATATTATGAA
AACGCTATTTTAGACAGCGT -> ACGCTATTTTAGACAGCGTC
GTGTTCGTGAGATGATGGGC -> TGTTCGTGAGATGATGGGCA
ACTCCGAATACCCCGACCTG -> CTCCGAATACCCCGACCTGA
GCGAATACGCGACCGACAGC -> CGAATACGCGACCGACAGCG
TACGGATTACTGTGGTTTCA -> ACGGATTACTGTGGTTTCAC
CGTCGCTAAACGCGTTTACG -> GTCGCTAAACGCGTTTACGG
TTACGGATTACTGTGGTTTC -> TACGGATTACTGTGGTTTCA
CTCTAGAATCACTAGTGTGT -> TCTAGAATCACTAGTGTGTT
TTTTCTGTCGATTATGTCGG -> TTTCTGTCGATTATGTCGGG
GGGGACAGATAATTGCGCAT -> GGGACAGATAATTGCGCATA
TTATGTCGGGTCCAGCAAGG -> TATGTCGGGTCCAGCAAGGT
TGAACAACCTATCATTAATC -> GAACAACCTATCATTAATCT
GCTCGATTGTGTGCGCCCGT -> CTCGATTGTGTGCGCCCGTT
TGCGCATACCCTTTGTGTAT -> GCGCATACCCTTTGTGTATC
ATCTCACCTATAGTTACACT -> TCTCACCTATAGTTACACTT
AGGCACTCCGAATACCCCGA -> GGCACTCCGAATACCCCGAC
TGAGGCCTCCTACTCTCCTA -> GAGGCCTCCTACTCTCCTAG
CTGGTCTCGCTCTACCAGCG -> TGGTCTCGCTCTACCAGCGA
ATATAAGCCCCCAGCATTCA -> TATAAGCCCCCAGCATTCAA
CAATACGCATGTAAAGGGCT -> AATACGCATGTAAAGGGCTT
AGTTGTCGGGTGCAGTCAAG -> GTTGTCGGGTGCAGTCAAGG
CAGATATTATGAACAACCTA -> AGATATTATGAACAACCTAT
AACAGCCCTTATGAAGGACG -> ACAGCCCTTATGAAGGACGG
TTTTCGGTTTTGACGTGACC -> TTTCGGTTTTGACGTGACCA
CTGCATCCCTATTTACTGTC -> TGCATCCCTATTTACTGTCA
GAGGCCTCCTACTCTCCTAG -> AGGCCTCCTACTCTCCTAGT
TCTCGCTCTACCAGCGAATA -> CTCGCTCTACCAGCGAATAC
ACCGCTTACGGATGGCTTAC -> CCGCTTACGGATGGCTTACC
ATATTATGAACAACCTATCA -> TATTATGAACAACCTATCAT
ATAGCCTAGGCTAGGACAGG -> TAGCCTAGGCTAGGACAGGT
TACAATACGCATGTAAAGGG -> ACAATACGCATGTAAAGGGC
GTTTTGACGTGACCATCTGA -> TTTTGACGTGACCATCTGAG
TTCGGTTTTGACGTGACCAT -> TCGGTTTTGACGTGACCATC
ACAGCGTCGCTAAACGCGTT -> CAGCGTCGCTAAACGCGTTT
CTAAATCACCCAATAGAGCC -> TAAATCACCCAATAGAGCCC
GCTGAGGCACTCCGAATACC -> CTGAGGCACTCCGAATACCC
ATGAACAACCTATCATTAAT -> TGAACAACCTATCATTAATC
TTCAGCATTCGTTGTACCGA -> TCAGCATTCGTTGTACCGAG
CTCGAGCGAGTCTTCTTACC -> TCGAGCGAGTCTTCTTACCT
CGAGCAACCGCTTACGGATG -> GAGCAACCGCTTACGGATGG
AGCCTAATATCAAATCTACA -> GCCTAATATCAAATCTACAA
CCGCTGTTTAGGTAGGTAGC -> CGCTGTTTAGGTAGGTAGCG
TTATGAACAACCTATCATTA -> TATGAACAACCTATCATTAA
CGCGTTTACGGATTACTGTG -> GCGTTTACGGATTACTGTGG
TGGCAACAGGAAACGAGGTC -> GGCAACAGGAAACGAGGTCA
TCACGGCCTAAATCACCCAA -> CACGGCCTAAATCACCCAAT
TAGTCACGACTCAATTTACA -> AGTCACGACTCAATTTACAC
TTGTGCAGATATTATGAACA -> TGTGCAGATATTATGAACAA
ACCAGCGAATACGCGACCGA -> CCAGCGAATACGCGACCGAC
ATGATGGGCACCGCTGTTTA -> TGATGGGCACCGCTGTTTAG
AATACCCCGACCTGAATCTA -> ATACCCCGACCTGAATCTAT
ATTTTAGACAGCGTCGCTAA -> TTTTAGACAGCGTCGCTAAA
TCCCCGTGGCAACCCAGTTC -> CCCCGTGGCAACCCAGTTCG
GCTTTAGTTTGTGCAGATAT -> CTTTAGTTTGTGCAGATATT
AATCTACAATACGCATGTAA -> ATCTACAATACGCATGTAAA
CGGAGCATATAAGCCCCCAG -> GGAGCATATAAGCCCCCAGC
TGTCGGGTCCAGCAAGGTGA -> GTCGGGTCCAGCAAGGTGAA
AGCGAGTCTTCTTACCTCTT -> GCGAGTCTTCTTACCTCTTA
CCTTATGAAGGACGGGCAAC -> CTTATGAAGGACGGGCAACG
TAGTTTGTGCAGATATTATG -> AGTTTGTGCAGATATTATGA
ATGGCTTACCATAGCCTAGG -> TGGCTTACCATAGCCTAGGC
AGTCTTTCGAACCGTCAACG -> GTCTTTCGAACCGTCAACGC
ATCATTTTCTGTCGATTATG -> TCATTTTCTGTCGATTATGT
GTTTTGTCTGAGGCCTCCTA -> TTTTGTCTGAGGCCTCCTAC
TATCAAATCTACAATACGCA -> ATCAAATCTACAATACGCAT
AGCGTCGCTAAACGCGTTTA -> GCGTCGCTAAACGCGTTTAC
GTGCTGAGTAGTTTCATTGT -> TGCTGAGTAGTTTCATTGTT
GAAACATTAACAGCCCTTAT -> AAACATTAACAGCCCTTATG
CTCACCTATAGTTACACTTT -> TCACCTATAGTTACACTTTT
GCGCCCGTTAATTTTCGGTT -> CGCCCGTTAATTTTCGGTTT
CCAGCATTCAAAACCTGAGG -> CAGCATTCAAAACCTGAGGA
TTACGGATGGCTTACCATAG -> TACGGATGGCTTACCATAGC
CCAATAGAGCCCGGGATCTC -> CAATAGAGCCCGGGATCTCA
GGGCTTTAGTTTGTGCAGAT -> GGCTTTAGTTTGTGCAGATA
CGCTCTACCAGCGAATACGC -> GCTCTACCAGCGAATACGCG
CGCTAAAGAACGCTATTTTA -> GCTAAAGAACGCTATTTTAG
TTCTGTCGATTATGTCGGGT -> TCTGTCGATTATGTCGGGTC
TTTTGTCTGAGGCCTCCTAC -> TTTGTCTGAGGCCTCCTACT
TCGCTAAACGCGTTTACGGA -> CGCTAAACGCGTTTACGGAT
CGAATACGCGACCGACAGCG -> GAATACGCGACCGACAGCGG
CTACCAGCGAATACGCGACC -> TACCAGCGAATACGCGACCG
ACTCAATTTACACTCCCCGT -> CTCAATTTACACTCCCCGTG
GAATACCCCGACCTGAATCT -> AATACCCCGACCTGAATCTA
TCGATTGTGTGCGCCCGTTA -> CGATTGTGTGCGCCCGTTAA
AGCCTAGGCTAGGACAGGTC -> GCCTAGGCTAGGACAGGTCA
GGAAACGAGGTCAAGGTCAT -> GAAACGAGGTCAAGGTCATA
GGCAACAGGAAACGAGGTCA -> GCAACAGGAAACGAGGTCAA
ACAGCCCTTATGAAGGACGG -> CAGCCCTTATGAAGGACGGG
AGGCTGGTCTCGCTCTACCA -> GGCTGGTCTCGCTCTACCAG
GACTCAATTTACACTCCCCG -> ACTCAATTTACACTCCCCGT
ATCTGAGATTTGGGCCTCTA -> TCTGAGATTTGGGCCTCTAG
GTCAACGCTCATACTGGCCT -> TCAACGCTCATACTGGCCTC
AGGCTTGATCCGGTGGAAAC -> GGCTTGATCCGGTGGAAACA
CAATTTACACTCCCCGTGGC -> AATTTACACTCCCCGTGGCA
CATAGTGTAGGTGGAGCGCT -> ATAGTGTAGGTGGAGCGCTA
TCTTTCGAACCGTCAACGCT -> CTTTCGAACCGTCAACGCTC
ATCTATTGGGGACAGATAAT -> TCTATTGGGGACAGATAATT
CATCTGAGATTTGGGCCTCT -> ATCTGAGATTTGGGCCTCTA
TTAGTTTGTGCAGATATTAT -> TAGTTTGTGCAGATATTATG
CCCAATAGAGCCCGGGATCT -> CCAATAGAGCCCGGGATCTC
TTCATTGTTGTAAGGGGCCG -> TCATTGTTGTAAGGGGCCGA
GGTAGCGTAACGTTTTGTCT -> GTAGCGTAACGTTTTGTCTG
CAGATAATTGCGCATACCCT -> AGATAATTGCGCATACCCTT
GCAGATATTATGAACAACCT -> CAGATATTATGAACAACCTA
CAACAGGAAACGAGGTCAAG -> AACAGGAAACGAGGTCAAGG
TGATCCGGTGGAAACATTAA -> GATCCGGTGGAAACATTAAC
CTCTACCAGCGAATACGCGA -> TCTACCAGCGAATACGCGAC
TCAGCATTCGTTGTACCGAG -> CAGCATTCGTTGTACCGAGC
CATGTAAAGGGCTTTAGTTT -> ATGTAAAGGGCTTTAGTTTG
AGAGCCCGGGATCTCACCTA -> GAGCCCGGGATCTCACCTAT
CCTGCATCCCTATTTACTGT -> CTGCATCCCTATTTACTGTC
TGCATCCCTATTTACTGTCA -> GCATCCCTATTTACTGTCAC
GTGCAGATATTATGAACAAC -> TGCAGATATTATGAACAACC
ACGCGTTTACGGATTACTGT -> CGCGTTTACGGATTACTGTG
GAAACGGTATCGCGCTTCAG -> AAACGGTATCGCGCTTCAGC
CTCGCTCTACCAGCGAATAC -> TCGCTCTACCAGCGAATACG
TGGAGCGTGATGCGGAGCAT -> GGAGCGTGATGCGGAGCATA
TGCCGAGCTAAATGGAGCTG -> GCCGAGCTAAATGGAGCTGT
TATAGTTACACTTTTGTGGC -> ATAGTTACACTTTTGTGGCA
CCTAATATCAAATCTACAAT -> CTAATATCAAATCTACAATA
TTTTGACGTGACCATCTGAG -> TTTGACGTGACCATCTGAGA
TATGAACAACCTATCATTAA -> ATGAACAACCTATCATTAAT
GACGGGCAACGCTCGATTGT -> ACGGGCAACGCTCGATTGTG
CAGCGAATACGCGACCGACA -> AGCGAATACGCGACCGACAG
CATTCAAAACCTGAGGATTA -> ATTCAAAACCTGAGGATTAA
GAGCGCTAAAGAACGCTATT -> AGCGCTAAAGAACGCTATTT
GTAAAGGGCTTTAGTTTGTG -> TAAAGGGCTTTAGTTTGTGC
CTCCTACTCTCCTAGTCACG -> TCCTACTCTCCTAGTCACGA
TCAAGGTCATAGTGTAGGTG -> CAAGGTCATAGTGTAGGTGG
GAATCTATTGGGGACAGATA -> AATCTATTGGGGACAGATAA
GATTAGAATCCTGCATCCCT -> ATTAGAATCCTGCATCCCTA
TAATCTTTGTTCGGACCCTC -> AATCTTTGTTCGGACCCTCG
CGGACCCTCGAACGAATCTG -> GGACCCTCGAACGAATCTGG
CGCATACCCTTTGTGTATCA -> GCATACCCTTTGTGTATCAT
AGCGCTAAAGAACGCTATTT -> GCGCTAAAGAACGCTATTTT
TAAATCACCCAATAGAGCCC -> AAATCACCCAATAGAGCCCG
AAATCACCCAATAGAGCCCG -> AATCACCCAATAGAGCCCGG
TACTGGCCTCCCAGAGCAAA -> ACTGGCCTCCCAGAGCAAAG
CGTTTTGTCTGAGGCCTCCT -> GTTTTGTCTGAGGCCTCCTA
TACCTAGATTAGAATCCTGC -> ACCTAGATTAGAATCCTGCA
CCGGTGGAAACATTAACAGC -> CGGTGGAAACATTAACAGCC
TACACTTTTGTGGCAACAGG -> ACACTTTTGTGGCAACAGGA
CGCTCATACTGGCCTCCCAG -> GCTCATACTGGCCTCCCAGA
TAATTGCGCATACCCTTTGT -> AATTGCGCATACCCTTTGTG
CTAGATTAGAATCCTGCATC -> TAGATTAGAATCCTGCATCC
ATTGCGCATACCCTTTGTGT -> TTGCGCATACCCTTTGTGTA
AATCACCCAATAGAGCCCGG -> ATCACCCAATAGAGCCCGGG
AAACATTAACAGCCCTTATG -> AACATTAACAGCCCTTATGA
GCCCGGGATCTCACCTATAG -> CCCGGGATCTCACCTATAGT
TTTCGAACCGTCAACGCTCA -> TTCGAACCGTCAACGCTCAT
GATATTATGAACAACCTATC -> ATATTATGAACAACCTATCA
TTCGTGAGATGATGGGCACC -> TCGTGAGATGATGGGCACCG
TGTGGTTTCACCATAGTTGT -> GTGGTTTCACCATAGTTGTC
CTTTGTTCGGACCCTCGAAC -> TTTGTTCGGACCCTCGAACG
GGGCACCGCTGTTTAGGTAG -> GGCACCGCTGTTTAGGTAGG
ACGAGGTCAAGGTCATAGTG -> CGAGGTCAAGGTCATAGTGT
ATCCCTATTTACTGTCACGG -> TCCCTATTTACTGTCACGGC
CCCAGCATTCAAAACCTGAG -> CCAGCATTCAAAACCTGAGG
TAAATGGAGCTGTACCTAGA -> AAATGGAGCTGTACCTAGAT
TTCACCATAGTTGTCGGGTG -> TCACCATAGTTGTCGGGTGC
TCAAAACCTGAGGATTAAAA -> CAAAACCTGAGGATTAAAAA
GCGTAACGTTTTGTCTGAGG -> CGTAACGTTTTGTCTGAGGC
GCTGTGCTAAAGTGCTGAGT -> CTGTGCTAAAGTGCTGAGTA
TTGTGTATCATTTTCTGTCG -> TGTGTATCATTTTCTGTCGA
AAGGCTTGATCCGGTGGAAA -> AGGCTTGATCCGGTGGAAAC
CTAGGCTAGGACAGGTCAGC -> TAGGCTAGGACAGGTCAGCC
GAGATGATGGGCACCGCTGT -> AGATGATGGGCACCGCTGTT
GTTCGCCGAGGCTGGTCTCG -> TTCGCCGAGGCTGGTCTCGC
CGCGACCGACAGCGGCTTAG -> GCGACCGACAGCGGCTTAGA
TGTTCGGACCCTCGAACGAA -> GTTCGGACCCTCGAACGAAT
TTTGACGTGACCATCTGAGA -> TTGACGTGACCATCTGAGAT
CAGCCCTTATGAAGGACGGG -> AGCCCTTATGAAGGACGGGC
CAACCTATCATTAATCTTTG -> AACCTATCATTAATCTTTGT
CTAGTGTGTTCGTGAGATGA -> TAGTGTGTTCGTGAGATGAT
GACAGGTCAGCCTAATATCA -> ACAGGTCAGCCTAATATCAA
GACCATCTGAGATTTGGGCC -> ACCATCTGAGATTTGGGCCT
CTACTCTCCTAGTCACGACT -> TACTCTCCTAGTCACGACTC
GCGCTTCAGCATTCGTTGTA -> CGCTTCAGCATTCGTTGTAC
CATTGTTGTAAGGGGCCGAT -> ATTGTTGTAAGGGGCCGATC
ATTTTCGGTTTTGACGTGAC -> TTTTCGGTTTTGACGTGACC
GTGACCATCTGAGATTTGGG -> TGACCATCTGAGATTTGGGC
CAGTTCGCCGAGGCTGGTCT -> AGTTCGCCGAGGCTGGTCTC
GGTGGAAACATTAACAGCCC -> GTGGAAACATTAACAGCCCT
GTCTGAGGCCTCCTACTCTC -> TCTGAGGCCTCCTACTCTCC
GGCACCGCTGTTTAGGTAGG -> GCACCGCTGTTTAGGTAGGT
ACGAATCTGGAGCGTGATGC -> CGAATCTGGAGCGTGATGCG
TTTACTGTCACGGCCTAAAT -> TTACTGTCACGGCCTAAATC
AACGAGGTCAAGGTCATAGT -> ACGAGGTCAAGGTCATAGTG
CTAGTCACGACTCAATTTAC -> TAGTCACGACTCAATTTACA
GATTACTGTGGTTTCACCAT -> ATTACTGTGGTTTCACCATA
TGACGTGACCATCTGAGATT -> GACGTGACCATCTGAGATTT
CCATCTGAGATTTGGGCCTC -> CATCTGAGATTTGGGCCTCT
TCGCTCTACCAGCGAATACG -> CGCTCTACCAGCGAATACGC
TAGGTAGGTAGCGTAACGTT -> AGGTAGGTAGCGTAACGTTT
ATCATTAATCTTTGTTCGGA -> TCATTAATCTTTGTTCGGAC
TTTCTGTCGATTATGTCGGG -> TTCTGTCGATTATGTCGGGT
GAGTCTTTCGAACCGTCAAC -> AGTCTTTCGAACCGTCAACG
TTTACGGATTACTGTGGTTT -> TTACGGATTACTGTGGTTTC
GCAGTCAAGGCTTGATCCGG -> CAGTCAAGGCTTGATCCGGT
GCTTGATCCGGTGGAAACAT -> CTTGATCCGGTGGAAACATT
CTAATATCAAATCTACAATA -> TAATATCAAATCTACAATAC
TCCGAATACCCCGACCTGAA -> CCGAATACCCCGACCTGAAT
ATTAAAAAAGCATTTGAGTC -> TTAAAAAAGCATTTGAGTCT
ACCGCTGAGGCACTCCGAAT -> CCGCTGAGGCACTCCGAATA
GATTGTGTGCGCCCGTTAAT -> ATTGTGTGCGCCCGTTAATT
GCAACAGGAAACGAGGTCAA -> CAACAGGAAACGAGGTCAAG
CCGCTGTGCTAAAGTGCTGA -> CGCTGTGCTAAAGTGCTGAG
GTGAGATGATGGGCACCGCT -> TGAGATGATGGGCACCGCTG
GCCTAATATCAAATCTACAA -> CCTAATATCAAATCTACAAT
TTTGTGGCAACAGGAAACGA -> TTGTGGCAACAGGAAACGAG
AAGGTGAAACGGTATCGCGC -> AGGTGAAACGGTATCGCGCT
TTGATCCGGTGGAAACATTA -> TGATCCGGTGGAAACATTAA
ACAGATAATTGCGCATACCC -> CAGATAATTGCGCATACCCT
TTTGTCTGAGGCCTCCTACT -> TTGTCTGAGGCCTCCTACTC
AGCATATAAGCCCCCAGCAT -> GCATATAAGCCCCCAGCATT
ATACGCATGTAAAGGGCTTT -> TACGCATGTAAAGGGCTTTA
GCCTAAATCACCCAATAGAG -> CCTAAATCACCCAATAGAGC
TCGAACCGTCAACGCTCATA -> CGAACCGTCAACGCTCATAC
AAACCTGAGGATTAAAAAAG -> AACCTGAGGATTAAAAAAGC
CTAAAGTGCTGAGTAGTTTC -> TAAAGTGCTGAGTAGTTTCA
CCTAGGCTAGGACAGGTCAG -> CTAGGCTAGGACAGGTCAGC
TTACTGTGGTTTCACCATAG -> TACTGTGGTTTCACCATAGT
GGTCCAGCAAGGTGAAACGG -> GTCCAGCAAGGTGAAACGGT
ATACTGGCCTCCCAGAGCAA -> TACTGGCCTCCCAGAGCAAA
TTTCACCATAGTTGTCGGGT -> TTCACCATAGTTGTCGGGTG
CGTTAATTTTCGGTTTTGAC -> GTTAATTTTCGGTTTTGACG
GGCTTTAGTTTGTGCAGATA -> GCTTTAGTTTGTGCAGATAT
AACGCGTTTACGGATTACTG -> ACGCGTTTACGGATTACTGT
TGTAAAGGGCTTTAGTTTGT -> GTAAAGGGCTTTAGTTTGTG
GGACCCTCGAACGAATCTGG -> GACCCTCGAACGAATCTGGA
CGCCGAGGCTGGTCTCGCTC -> GCCGAGGCTGGTCTCGCTCT
TTGTTGTAAGGGGCCGATCT -> TGTTGTAAGGGGCCGATCTC
AAGGACGGGCAACGCTCGAT -> AGGACGGGCAACGCTCGATT
GCACTCCGAATACCCCGACC -> CACTCCGAATACCCCGACCT
GTACCGAGCAACCGCTTACG -> TACCGAGCAACCGCTTACGG
CGTCAACGCTCATACTGGCC -> GTCAACGCTCATACTGGCCT
AGGGGCCGATCTCGAGCGAG -> GGGGCCGATCTCGAGCGAGT
TGCAGTCAAGGCTTGATCCG -> GCAGTCAAGGCTTGATCCGG
CATTAATCTTTGTTCGGACC -> ATTAATCTTTGTTCGGACCC
CAAAACCTGAGGATTAAAAA -> AAAACCTGAGGATTAAAAAA
GGCCTCCTACTCTCCTAGTC -> GCCTCCTACTCTCCTAGTCA
GCTGTACCTAGATTAGAATC -> CTGTACCTAGATTAGAATCC
TATGTCGGGTCCAGCAAGGT -> ATGTCGGGTCCAGCAAGGTG
GACAGCGTCGCTAAACGCGT -> ACAGCGTCGCTAAACGCGTT
TGTAAGGGGCCGATCTCGAG -> GTAAGGGGCCGATCTCGAGC
ATTGTTGTAAGGGGCCGATC -> TTGTTGTAAGGGGCCGATCT
AGACAGCGTCGCTAAACGCG -> GACAGCGTCGCTAAACGCGT
AGTTCGCCGAGGCTGGTCTC -> GTTCGCCGAGGCTGGTCTCG
CAGCCTAATATCAAATCTAC -> AGCCTAATATCAAATCTACA
GGGCAACGCTCGATTGTGTG -> GGCAACGCTCGATTGTGTGC
TAGGCTAGGACAGGTCAGCC -> AGGCTAGGACAGGTCAGCCT
GCCCCCAGCATTCAAAACCT -> CCCCCAGCATTCAAAACCTG
GAGGATTAAAAAAGCATTTG -> AGGATTAAAAAAGCATTTGA
TATCATTTTCTGTCGATTAT -> ATCATTTTCTGTCGATTATG
CTAAATGGAGCTGTACCTAG -> TAAATGGAGCTGTACCTAGA
AGCATTTGAGTCTTTCGAAC -> GCATTTGAGTCTTTCGAACC
TCCGGTGGAAACATTAACAG -> CCGGTGGAAACATTAACAGC
GAGCTGTACCTAGATTAGAA -> AGCTGTACCTAGATTAGAAT
CCGATCTCGAGCGAGTCTTC -> CGATCTCGAGCGAGTCTTCT
GCTGAGTAGTTTCATTGTTG -> CTGAGTAGTTTCATTGTTGT
TACCAGCGAATACGCGACCG -> ACCAGCGAATACGCGACCGA
TGGCCTCCCAGAGCAAAGGA -> GGCCTCCCAGAGCAAAGGAG
TGAGGATTAAAAAAGCATTT -> GAGGATTAAAAAAGCATTTG
GACAGATAATTGCGCATACC -> ACAGATAATTGCGCATACCC
TTGAGTCTTTCGAACCGTCA -> TGAGTCTTTCGAACCGTCAA
GGCAACGCTCGATTGTGTGC -> GCAACGCTCGATTGTGTGCG
ATTTGAGTCTTTCGAACCGT -> TTTGAGTCTTTCGAACCGTC
CGCTGTTTAGGTAGGTAGCG -> GCTGTTTAGGTAGGTAGCGT
GTTCGTGAGATGATGGGCAC -> TTCGTGAGATGATGGGCACC
CAGCATTCGTTGTACCGAGC -> AGCATTCGTTGTACCGAGCA
GTGTGTTCGTGAGATGATGG -> TGTGTTCGTGAGATGATGGG
CATATAAGCCCCCAGCATTC -> ATATAAGCCCCCAGCATTCA
TCCTAGTCACGACTCAATTT -> CCTAGTCACGACTCAATTTA
ACGACTCAATTTACACTCCC -> CGACTCAATTTACACTCCCC
TACGGATGGCTTACCATAGC -> ACGGATGGCTTACCATAGCC
GTGCTAAAGTGCTGAGTAGT -> TGCTAAAGTGCTGAGTAGTT
AGTAGTTTCATTGTTGTAAG -> GTAGTTTCATTGTTGTAAGG
CGTGGCAACCCAGTTCGCCG -> GTGGCAACCCAGTTCGCCGA
CAACCCAGTTCGCCGAGGCT -> AACCCAGTTCGCCGAGGCTG
AATCTTTGTTCGGACCCTCG -> ATCTTTGTTCGGACCCTCGA
TGTTTAGGTAGGTAGCGTAA -> GTTTAGGTAGGTAGCGTAAC
GGCTTACCATAGCCTAGGCT -> GCTTACCATAGCCTAGGCTA
GCACCGCTGTTTAGGTAGGT -> CACCGCTGTTTAGGTAGGTA
TCACCTATAGTTACACTTTT -> CACCTATAGTTACACTTTTG
GCTTACGGATGGCTTACCAT -> CTTACGGATGGCTTACCATA
AATGGAGCTGTACCTAGATT -> ATGGAGCTGTACCTAGATTA
AAAGTGCTGAGTAGTTTCAT -> AAGTGCTGAGTAGTTTCATT
AGCTAAATGGAGCTGTACCT -> GCTAAATGGAGCTGTACCTA
GGTGAAACGGTATCGCGCTT -> GTGAAACGGTATCGCGCTTC
GACAGCGGCTTAGACCGCTG -> ACAGCGGCTTAGACCGCTGA
ACCCAATAGAGCCCGGGATC -> CCCAATAGAGCCCGGGATCT
CTCAATTTACACTCCCCGTG -> TCAATTTACACTCCCCGTGG
GTCGGGTGCAGTCAAGGCTT -> TCGGGTGCAGTCAAGGCTTG
TAACAGCCCTTATGAAGGAC -> AACAGCCCTTATGAAGGACG
AGATAATTGCGCATACCCTT -> GATAATTGCGCATACCCTTT
ATCGCGCTTCAGCATTCGTT -> TCGCGCTTCAGCATTCGTTG
AGTTTCATTGTTGTAAGGGG -> GTTTCATTGTTGTAAGGGGC
GACCCTCGAACGAATCTGGA -> ACCCTCGAACGAATCTGGAG
CTGAATCTATTGGGGACAGA -> TGAATCTATTGGGGACAGAT
GCTCTACCAGCGAATACGCG -> CTCTACCAGCGAATACGCGA
TTTAGACAGCGTCGCTAAAC -> TTAGACAGCGTCGCTAAACG
TCATTAATCTTTGTTCGGAC -> CATTAATCTTTGTTCGGACC
CGCTTACGGATGGCTTACCA -> GCTTACGGATGGCTTACCAT
CCTATAGTTACACTTTTGTG -> CTATAGTTACACTTTTGTGG
CCTCTAGAATCACTAGTGTG -> CTCTAGAATCACTAGTGTGT
GTGGAAACATTAACAGCCCT -> TGGAAACATTAACAGCCCTT
GAGATTTGGGCCTCTAGAAT -> AGATTTGGGCCTCTAGAATC
AGAGCAAAGGAGGAAAGCCG -> GAGCAAAGGAGGAAAGCCGC
CGGCCTAAATCACCCAATAG -> GGCCTAAATCACCCAATAGA
AACATTAACAGCCCTTATGA -> ACATTAACAGCCCTTATGAA
TTGTAAGGGGCCGATCTCGA -> TGTAAGGGGCCGATCTCGAG
CCAGCAAGGTGAAACGGTAT -> CAGCAAGGTGAAACGGTATC
ATGCGGAGCATATAAGCCCC -> TGCGGAGCATATAAGCCCCC
ATTAACAGCCCTTATGAAGG -> TTAACAGCCCTTATGAAGGA
AGCTGTACCTAGATTAGAAT -> GCTGTACCTAGATTAGAATC
CTTTAGTTTGTGCAGATATT -> TTTAGTTTGTGCAGATATTA
AGAATCACTAGTGTGTTCGT -> GAATCACTAGTGTGTTCGTG
TCGATTATGTCGGGTCCAGC -> CGATTATGTCGGGTCCAGCA
CTGTGGTTTCACCATAGTTG -> TGTGGTTTCACCATAGTTGT
ATAGTTACACTTTTGTGGCA -> TAGTTACACTTTTGTGGCAA
CTCGATTGTGTGCGCCCGTT -> TCGATTGTGTGCGCCCGTTA
GTATCATTTTCTGTCGATTA -> TATCATTTTCTGTCGATTAT
CGCTAAACGCGTTTACGGAT -> GCTAAACGCGTTTACGGATT
GTCGATTATGTCGGGTCCAG -> TCGATTATGTCGGGTCCAGC
GCGCTAAAGAACGCTATTTT -> CGCTAAAGAACGCTATTTTA
TAGAATCCTGCATCCCTATT -> AGAATCCTGCATCCCTATTT
ATACGCGACCGACAGCGGCT -> TACGCGACCGACAGCGGCTT
GTGCAGTCAAGGCTTGATCC -> TGCAGTCAAGGCTTGATCCG
CACCCAATAGAGCCCGGGAT -> ACCCAATAGAGCCCGGGATC
AGCGTGATGCGGAGCATATA -> GCGTGATGCGGAGCATATAA
CCCCGTGGCAACCCAGTTCG -> CCCGTGGCAACCCAGTTCGC
GGCTTAGACCGCTGAGGCAC -> GCTTAGACCGCTGAGGCACT
TGTCGGGTGCAGTCAAGGCT -> GTCGGGTGCAGTCAAGGCTT
GATTAAAAAAGCATTTGAGT -> ATTAAAAAAGCATTTGAGTC
GAACGAATCTGGAGCGTGAT -> AACGAATCTGGAGCGTGATG
GATCCGGTGGAAACATTAAC -> ATCCGGTGGAAACATTAACA
CAGCAAGGTGAAACGGTATC -> AGCAAGGTGAAACGGTATCG
GAGCGAGTCTTCTTACCTCT -> AGCGAGTCTTCTTACCTCTT
CGGCTTAGACCGCTGAGGCA -> GGCTTAGACCGCTGAGGCAC
TGAGGCACTCCGAATACCCC -> GAGGCACTCCGAATACCCCG
AGCCCCCAGCATTCAAAACC -> GCCCCCAGCATTCAAAACCT
TCATTGTTGTAAGGGGCCGA -> CATTGTTGTAAGGGGCCGAT
GAGCGTGATGCGGAGCATAT -> AGCGTGATGCGGAGCATATA
GGATTAAAAAAGCATTTGAG -> GATTAAAAAAGCATTTGAGT
GCATCCCTATTTACTGTCAC -> CATCCCTATTTACTGTCACG
CTGTACCTAGATTAGAATCC -> TGTACCTAGATTAGAATCCT
GCGAGTCTTCTTACCTCTTA -> CGAGTCTTCTTACCTCTTAT
TCACGACTCAATTTACACTC -> CACGACTCAATTTACACTCC
GGACAGGTCAGCCTAATATC -> GACAGGTCAGCCTAATATCA
GCTGGTCTCGCTCTACCAGC -> CTGGTCTCGCTCTACCAGCG
GTGCGCCCGTTAATTTTCGG -> TGCGCCCGTTAATTTTCGGT
ATCTACAATACGCATGTAAA -> TCTACAATACGCATGTAAAG
CACTAGTGTGTTCGTGAGAT -> ACTAGTGTGTTCGTGAGATG
AAAGCCGCTGTGCTAAAGTG -> AAGCCGCTGTGCTAAAGTGC
CCCGTTAATTTTCGGTTTTG -> CCGTTAATTTTCGGTTTTGA
AGTGTGTTCGTGAGATGATG -> GTGTGTTCGTGAGATGATGG
GCCTCCCAGAGCAAAGGAGG -> CCTCCCAGAGCAAAGGAGGA
CCCAGTTCGCCGAGGCTGGT -> CCAGTTCGCCGAGGCTGGTC
CGAATCTGGAGCGTGATGCG -> GAATCTGGAGCGTGATGCGG
TTACCATAGCCTAGGCTAGG -> TACCATAGCCTAGGCTAGGA
ACCGACAGCGGCTTAGACCG -> CCGACAGCGGCTTAGACCGC
GGACGGGCAACGCTCGATTG -> GACGGGCAACGCTCGATTGT
TACTGTCACGGCCTAAATCA -> ACTGTCACGGCCTAAATCAC
TCTTTGTTCGGACCCTCGAA -> CTTTGTTCGGACCCTCGAAC
ACGCATGTAAAGGGCTTTAG -> CGCATGTAAAGGGCTTTAGT
TATTTACTGTCACGGCCTAA -> ATTTACTGTCACGGCCTAAA
GGGTGCAGTCAAGGCTTGAT -> GGTGCAGTCAAGGCTTGATC
AATACGCGACCGACAGCGGC -> ATACGCGACCGACAGCGGCT
TGTACCTAGATTAGAATCCT -> GTACCTAGATTAGAATCCTG
GCTAAAGTGCTGAGTAGTTT -> CTAAAGTGCTGAGTAGTTTC
CTGGCCTCCCAGAGCAAAGG -> TGGCCTCCCAGAGCAAAGGA
CTGTGCTAAAGTGCTGAGTA -> TGTGCTAAAGTGCTGAGTAG
CTGAGGATTAAAAAAGCATT -> TGAGGATTAAAAAAGCATTT
AAACGGTATCGCGCTTCAGC -> AACGGTATCGCGCTTCAGCA
AATACGCATGTAAAGGGCTT -> ATACGCATGTAAAGGGCTTT
TTTTGTGGCAACAGGAAACG -> TTTGTGGCAACAGGAAACGA
GAGCAACCGCTTACGGATGG -> AGCAACCGCTTACGGATGGC
TTACACTCCCCGTGGCAACC -> TACACTCCCCGTGGCAACCC
GGTGCAGTCAAGGCTTGATC -> GTGCAGTCAAGGCTTGATCC
